0,0,0,0,0,0,0,3,0,0,0,0,0,0,0
0,0,0,0,0,0,0,3,0,0,0,0,0,0,0
0,0,0,0,0,68,0,3,0,0,0,0,0,0,0
0,0,0,0,2,2,2,3,0,0,0,0,0,0,0
0,0,0,0,0,0,0,3,0,0,0,5,0,0,0
0,0,0,0,0,0,0,3,0,0,2,2,2,0,0
0,0,0,0,0,0,0,3,0,0,0,0,0,0,0
0,0,0,0,0,0,0,3,0,61,0,0,0,0,0
60,0,0,0,0,0,0,3,2,2,0,0,0,0,0
2,2,2,2,2,0,0,3,0,0,0,0,0,0,0
0,0,0,0,0,0,0,3,0,0,0,0,0,0,0
0,0,0,0,0,0,0,3,0,0,0,0,0,66,0
0,0,0,0,0,0,0,3,0,0,0,0,2,2,2
0,0,0,67,5,0,0,3,0,0,0,0,0,0,0
0,0,2,2,2,0,0,3,0,0,0,0,0,0,0