0,0,0,0,0,0,0,0,0,0,0,0,0,0,0,0,0,0,0
0,0,0,0,0,0,0,0,0,0,0,0,0,0,0,0,0,0,0
0,0,0,0,5,0,0,0,62,67,64,0,0,0,0,0,0,0,0
0,2,2,2,2,2,2,2,1,1,1,2,2,2,2,2,2,2,0
0,0,0,0,0,0,0,0,0,0,0,0,0,0,0,0,0,0,0
0,0,0,0,0,0,0,0,0,0,0,0,0,0,0,0,0,0,0
0,64,0,0,0,0,61,0,65,62,65,0,0,0,0,0,0,65,0
1,1,1,0,0,0,1,1,1,1,1,1,1,0,0,0,1,1,1