1,1,1,1,1,1,1,1,1,1,1,1,1,1,1
1,0,0,0,0,0,0,0,0,0,0,0,0,0,1
1,0,0,0,0,0,0,0,0,0,0,0,0,0,1
1,0,0,0,0,0,0,0,0,0,0,0,0,0,1
1,0,0,0,0,0,0,50,0,0,0,0,0,0,1
1,0,0,2,2,2,2,2,2,2,2,2,0,0,1
1,0,0,0,0,0,0,0,0,0,0,0,0,0,1
1,0,0,62,0,0,0,61,0,0,0,62,0,0,1
1,1,1,1,1,1,1,1,1,1,1,1,1,1,1