1,1,1,1,1,1,1,1,1,1,1,1,1,1,1
1,1,1,1,1,1,1,0,0,0,0,0,1,1,1
1,1,1,1,0,0,0,0,0,61,0,0,0,1,1
1,1,0,0,0,0,0,0,2,11,2,0,0,0,1
1,0,0,0,0,0,0,0,0,3,0,0,0,0,1
1,0,0,0,0,0,0,0,0,3,0,0,0,0,1
1,0,0,0,0,0,0,0,0,3,0,0,0,0,1
1,0,60,64,0,0,5,0,0,3,0,0,64,0,1
1,1,1,1,1,1,1,1,1,1,1,1,1,1,1