1,1,1,1,1,1,1,1,1,1,1
1,0,0,0,0,0,0,0,0,1,1
1,0,0,0,0,0,0,0,0,0,1
1,0,64,0,0,0,0,0,0,0,1
1,1,1,0,0,0,0,64,5,0,1
1,1,1,0,0,0,1,1,1,1,1
1,1,0,0,0,0,1,1,1,1,1
1,0,0,0,0,0,0,1,1,1,1
1,0,64,0,0,0,0,0,0,1,1
1,1,1,1,0,0,0,0,0,0,1
1,1,1,1,0,0,0,0,0,0,1
1,1,1,0,0,0,62,0,64,0,1
1,1,1,1,1,1,1,1,1,1,1