1,1,1,1,1,1,1,1,1
1,0,0,0,0,0,0,0,1
1,0,0,0,0,0,0,0,1
1,0,0,0,10,0,0,0,1
1,0,0,2,2,2,0,0,1
1,0,0,0,0,0,0,0,1
1,0,0,0,0,0,0,0,1
1,60,0,69,0,0,60,0,1
1,1,1,1,1,1,1,1,1