1,1,1,1,1,1,1,1,1
1,0,0,0,0,0,0,0,1
1,0,0,0,0,0,0,0,1
1,0,0,0,0,0,0,0,1
1,0,70,0,50,0,0,61,1
1,2,2,2,2,2,2,2,1
1,0,0,0,0,0,0,0,1
1,0,60,0,0,61,0,60,1
1,1,1,1,1,1,1,1,1