1,1,1,1,1,1,1,1,1,1,1,1,1,1,1
1,1,1,1,1,1,0,0,0,0,0,0,0,0,1
1,1,1,1,1,1,0,0,0,0,0,0,0,0,1
1,1,1,1,1,1,0,60,0,5,0,62,0,0,1
1,1,1,1,1,1,1,1,1,2,2,2,11,2,1
1,0,0,0,0,0,0,0,0,0,0,0,3,0,1
1,0,0,0,0,0,0,0,0,0,0,0,3,0,1
1,0,0,0,0,0,0,0,0,0,0,0,3,0,1
1,0,0,0,0,0,0,0,0,0,0,0,3,0,1
1,0,0,0,60,0,63,0,5,0,66,0,3,0,1
1,2,2,2,2,2,1,1,1,1,1,1,1,1,1
1,0,0,0,0,0,0,0,0,0,0,0,0,0,1
1,0,0,0,0,0,0,0,0,0,0,0,0,0,1
1,0,0,68,0,62,0,0,0,66,0,0,63,0,1
1,1,1,1,1,1,1,1,1,1,1,1,1,1,1