1,1,1,1,1,1,1,1,1,1,1,1,1,1,1,1,1
1,0,0,0,0,0,0,0,0,0,0,0,0,0,0,0,1
1,0,0,0,0,0,0,0,0,0,0,0,0,0,0,0,1
1,0,0,0,0,0,0,0,0,68,0,0,0,0,0,0,1
1,0,0,0,0,0,2,2,2,2,2,0,0,0,0,0,1
1,0,0,0,0,0,0,0,0,0,0,0,0,0,0,0,1
1,0,0,0,0,0,0,0,0,0,0,0,0,0,0,0,1
1,0,0,60,0,64,0,0,0,5,0,0,0,61,0,0,1
1,1,1,1,1,1,1,1,1,1,1,1,1,1,1,1,1